20 20
09 10 11 10 11 10 11 06 07 -1 -2 06 07 10 11 06 07 10 11 06
07 00 00 00 00 00 00 06 07 -3 -4 00 00 00 00 00 00 00 00 06
07 00 00 00 00 00 00 06 07 00 00 00 00 00 00 00 00 00 00 06
07 00 00 08 09 00 00 06 07 06 07 08 09 10 11 06 07 00 00 06
09 00 00 08 09 00 00 06 07 08 09 10 11 00 00 00 00 00 00 06
07 00 00 08 09 00 00 06 07 00 00 10 11 00 00 00 00 00 00 06
07 00 00 08 09 00 00 08 09 00 00 06 07 00 00 06 07 00 00 06
07 00 00 08 09 00 00 10 11 00 00 08 09 00 00 06 07 00 00 06
07 00 00 08 09 00 00 10 11 02 03 06 07 00 00 06 07 10 11 06
07 00 00 08 09 00 00 00 00 04 05 08 09 00 00 00 00 00 00 06
07 00 00 08 09 00 00 00 00 00 00 08 09 00 00 00 00 00 00 06
07 00 00 08 09 08 09 08 09 00 00 08 09 08 09 06 07 00 00 06
07 00 00 06 07 10 11 10 11 00 00 08 09 10 11 06 07 00 00 06
07 00 00 08 09 00 00 00 00 00 00 08 09 00 00 00 00 00 00 06
07 00 00 06 07 00 00 00 00 00 00 08 09 00 00 00 00 00 00 06
07 00 00 08 09 00 00 08 09 08 09 08 09 00 00 08 09 00 00 06
07 00 00 10 11 00 00 10 11 10 11 10 11 00 00 10 11 00 00 06
07 00 00 06 07 00 00 00 00 00 00 00 00 00 00 00 00 00 00 06
07 00 00 08 09 00 00 00 00 00 00 00 00 00 00 00 00 00 00 06
07 07 07 07 07 07 07 07 07 07 07 07 07 07 07 07 07 07 07 07
