20 20
09 12 13 12 13 12 13 06 07 12 13 06 07 12 13 06 07 -1 -2 06
07 00 00 00 00 00 00 06 07 00 00 06 07 00 00 06 07 -3 -4 06
07 00 00 00 00 00 00 06 07 00 00 06 07 00 00 06 07 00 00 06
07 08 09 08 09 00 00 06 07 00 00 06 07 00 00 06 07 00 00 06
09 12 13 08 09 00 00 06 07 00 00 08 09 00 00 06 07 00 00 06
07 00 00 08 09 00 00 06 07 00 00 12 13 00 00 06 07 00 00 06
07 00 00 08 09 00 00 06 07 00 00 00 00 00 00 06 07 00 00 06
07 00 00 08 09 00 00 08 09 00 00 00 00 00 00 06 07 00 00 06
07 00 00 08 09 00 00 12 13 02 03 06 07 00 00 06 07 00 00 06
07 00 00 08 09 00 00 00 00 04 05 08 09 00 00 06 07 00 00 06
07 00 00 08 09 00 00 00 00 00 00 08 09 00 00 06 07 00 00 06
07 00 00 08 09 08 09 08 09 00 00 08 09 00 00 06 07 00 00 06
07 00 00 12 13 12 13 12 13 00 00 08 09 00 00 06 07 00 00 06
07 00 00 00 00 00 00 00 00 00 00 08 09 00 00 06 07 00 00 06
07 00 00 00 00 00 00 00 00 00 00 08 09 00 00 08 09 00 00 06
07 00 00 08 09 08 09 08 09 08 09 08 09 00 00 08 09 00 00 06
07 00 00 12 13 12 13 12 13 12 13 12 13 00 00 12 13 00 00 06
07 00 00 00 00 00 00 00 00 00 00 00 00 00 00 00 00 00 00 06
07 00 00 00 00 00 00 00 00 00 00 00 00 00 00 00 00 00 00 06
07 07 07 07 07 07 07 07 07 07 07 07 07 07 07 07 07 07 07 07
